--------------------------=====^^^^^^^^^^^^^^^^^^^^^^^^^^^^^^^^^^^^^^^^^^^^^^^^^^^^^^^^^^^^^^^^^^^^^^^^^^^^^^^^^^^^^^^^^^^^^^^^^^^^^^^^
----------------------=====""""""^^^^^^^^^^^^^^^^^^^^^^^^^^^^^^^^^^^^^^^^^^^^^^^^^^^^^^^^^^^^"&&&&&&&&&&&&&"""""""^^^^^^^^^^^^^^^^^^^^^
---------==============&&&&""""^^^^^^^^^^^^^^^^^^^^^^^^^^""""&&&"&""""""=&&&&=""&&"&&&&&&&&&&""""&&&""^^^^^^^^^^^^^^^^^^^^^^^^^^^^^^^^^
-------===""""&&"""""""""""&&&"""^^^^^^^^^^^^^^^^""""="""""&"&&&&&&&""===&&&&&="""""""&&&&&&&&&&"""&&&""""""^^^^^^^^^^""""^^^^^^^^^^^^^
----====""""&&&&&&""""""&&&&&"""""""^^^^^"""""""""""="""""&&&&"&&"""======&&&"&=""""""""""""""""""""""&&""""""^^^^"""&&&&&""""^^^^^^^^^
--==="""""&&""&""""""""^^^^^^^^"""""""^^^""""""""""=""""""""&"&""======="&"&&&&"="""""""""""&&&^^^"""""""""&""""^""""""""""&&""""^^^^^^
===""""""""&&&""""&""^^^^^^^^==""""""""""&""""""""="""""""""""&&&&"======&&&&&""="""&&&&"""&&^^^^^^^^"""&&&""""""&"&""~~~~""""""""""^^^
="""""===""""&&&&&"""""^^======="""&"&&&&&&&"""""=""""""""&&"""""&&""==""&&""""="""""""""&&&&&&&&"""^^"""""""&&&""""~~~~~~~~~""""""""^^
="""===-=="""""&&"""""""""=====""""""&&""""""""==""""""&&""""""""""&&""""""""=="""""""""""""&&"""""""""""""""""""""""""~~~~~~~~"""""""=
=====----===""""""&&""""""""==="""""""""""""===""""""""""&&&&"""&""""""======"""""""^"""""""""&"&&""""""""""""""""""&&&&"""~~~"""""""==
-----------==="""""""""""&&""""""""""""""""="""""""""&""&"""""""""====="""""""""""^^^^""^^"""""""&&&"""""""""""""""""""&&"""~"""""""==-
-----------==="""""""""""""""""""""""&&&&"=""""""&&&&&&&""""""&&&="""""""""""&&"""""""^""^""""""""""""""""==="""""""""""""""""""""""===
---------==="""""""&&&""""""&&"""""&&&""=="""""&&&&&&""&&&"""&&&=&&&&&"""""""""&"""^""""""""""""""""""""===""""""""""""""&"""""&""""""=
--------==""""""""""&&""&&&"""""&&&"&""="""""""""&&&&&&""""&&&&=&&&&&&&""""""""""&""""""""&&&&&""&""""========="""""""""""""""""""""""=
------==="""""&&""&&&&&&&&&""""""""===="&"""""""""""""""&&&&&&&=&&&"""""""""""""""""""""""""""&&&"""""""========""""~~~~""""""""&""""==
---===="""""&&&&&&&&&"""""""""""""="&&&&"""""""&""""""&&&&&&&&&&=&&&&&&&&&&&&"""""""""""""""""""""""""""""===="""~~~~~~~~"""""""""&""==
--==""""""""""&""""""""""""""=====""""&&""""""""""""&&&&&&&&&&&&&=&&&&&&&&&&&&&&&"""&""""""""""&&&""""""""""=""~~~~~~~~~~~~~""""""""""=
-=="""""""&&"""""""&&""""====""""&""""""""""&&"&&&&&&&&&&&&&&&&&&&=&&&&&&&&&&&&&&&""""&""""""""""""""""""""""""~~~~~~~~~~~~~~~"""""""==
=="""""""&"""""""&&&&&===""""""""""""""""""""&&&&&&&&&&&&&&&&&"""""=="""""""&&&&&&&&&&&&&""""&""""""""""""""~~~~~~~~~~~~"""""""""""===-
=""""&&"""""&&&&&&&&"="""""""""""""""""""&&&&&&&&&&&&&&&&&&&&&&&&""""===""&&&&&&&&"""&&"""""&&""""""""~~~~~~~~~~~~~~~~"""""""""""""==--
=""""""""&&"""&&"===="""""""""""&&"""""""""&&&&&&&&&&&&&&&&&""""""""""""=""""&&&&&&""""&"""&&&&&""""""""""""~~~~~~~~~~~~~~~~~"""""""===
=""""""=========="""""""""""~~~"""""&&""""""""&&&&&&&&&&&""""""""""""""""==""""&&&&&&&&""&&&&&&&""""&""""""""""""~~~~~~~~~~"""""""""""=
="""==="""""&"&""""""""~~~~~~~~~~"""""""""&""&&&""""&&&&&&&&&&&&&&&&&""""""=""""""""&&&&&&&&&&&&&""""""""""""""""""~~~~~~~~~~~""""""""=
===="""""&"&&&"""""~~~~~~~~~~~~~~~~"""""""""""""""&""""&&&&&&&&&&&&&&&&&""""="&&&&&&&&&&&&""""""""""""""""""""""""~~~~~~~~~"""""""""""=
==""""""""&&&&&""~~~~~~~~~~"""""""""""""""""""""""""&"""&&&&&&&&&&&&&&&&&&&=&&&&&&&&&&&&&&&&""&""""""""""""""&&&""""~~~~"""""""""""====
-===""""""&""""&&&"""""~~~~~~~"""""""""""""&""""&&&&""""""""&""""""""&""""=&&&&&&&&&&&&""""""""&&""""""&&&&&&&"&"&""""~"""""""""""""==-
---=====""""&&"""""""""""""~~""""""""&&&"""""""""""""""""&&&&&&&&&&"&"""==&&&&&&&&"""""""""""""""""""""""""""""""""""""""""~"""""""""==
-------==""""""&&&&"""""~~~~~~~~"""""""""""""""""""""""""""&&&&""&""""==&&&&&&&&&&&""&&&"""""""""""""""""&&""&&"""""""""~~~~~"""""""""=
--------==""""&&&"""""""""""""~"""""""""""""""""""&&"""""""""&&&"""""="""""""""""""""""""&"""="""""""""""""&"&""""""""""""~~~~~""""""==
---------====""""""&&"""""&"""""""""""~~"""""""""""""""""&&""""&&&""="""""""""""&"""""""""""""="""""""""""""&&""""~~~~~~~""~~~""""""""=
----====----="""""""""""""""""""""~~~~~~~""""""""""""""""""""""""""="""""""""""""""""""""&"""===""&"""&"&"""&"&"""""~~~~~~~~""""&"&"""=
---==""===--====""""""&"""&"""""""""~~""""""""""""&"""""""""""&"""="""""""""&&"&"""&""""""""==-=="""&&&""&"""&""""""""~~~~~""""&&"&""==
---="""="==----===""""""""""""""""""""~"~""""""&"&""""""""&""""""="""""&"&""&&&"&&&"&"""""===---==""""""&"&&&"&&""""""""""""""""&&"""==
---==="^""=------=============""""""""""""~"""""""""""""&""""""&"="&&"&""&&&&&&&&&&&&&"""&""====-==""""""&"&&&""&"""""""""""""&"""""""=
-====""&"&===----------------======""""""""""""""""""&&&"""&&"&""="&&&"&"&&&&""&""&""&"""&"&"""==-=="""&"""""&&&&"&""""""""""""""""====
-="&"""^^&""====------------------========="""""""""""""""&&&&&&"=""&"&"&&"""&"&&&""&&""""&&""""=--=="""""""""""""&"""""""""""======---
-======"^^&"&&"=--------------------------=========""""&&"""&&&"=="""&"&&&&"""&"&&&&""&&"""&=====---="""&""""&&"""""""=========--------
------="""^^"===--------------------------------="""""""&""&""=====""""""""""&""""&""""""""==-------="""""""""""""=====----------------
------==="&&&"=---------------------------------======""""""===---======""""""&"&""""""""===--------===""""&""=====--------------------
--------=======--------------------------------------========----------===================------------=========------------------------